1111111
1EC00C1
110XSS1
1P000C1
1111111
