111111111111111111111111111
100C00CC0000000001XCCC00001
10PSX00C000CCCX001C0S001001
1SSS00SS000SSSS001111111X01
100000CS0000000000000000001
1000CSCSSSSCSSSSCX00SS00111
100XCCCX0000CS00CC0SS00XE01
1000000C000CX00S0000CCCC001
111111111111111111111111111
