11111111111
100C00CC011
10PX100C011
11111X01S01
100000C1001
1000C1C1S01
1S00C1C1X01
10S0CCCCE01
11111111111
