1111111111111111111
100C00CC100S00S0CC1
1SP0X0C100CCCX000S1
1111000S1000000S001
100001C000000X00001
1000C1CS011C1111C01
100XCCCX000CS0XCC01
1000000C000C000SE01
1111111111111111111
