1111111111111111111
100C00CC000SSSSS001
1XPS000C000CCCXS001
1SSS000S0000000S001
100000CS00000X00001
1000C0CS000CSSSSC01
100XCCCX000CS0XCC01
1000000C000C000E001
1111111111111111111
