1111111
1EC0001
1XCSS01
1000SP1
1111111
