111111111111111111
100C00CC00S00S0SS1
1SP0X0C10CCCX000S1
1111000S100000S001
1000C1CS01C1111C01
100XCCCX00CS0XCE01
10000S000000000001
111111111111111111
