1111111111111111111
100C00CC00000000001
10PSX00C000CCCX0001
1SSS00SS000SSSS0001
100000CS00000000001
1000CSCSSSSCSSSSCX1
100XCCCX0000CS00CC1
1000000C000CX00E001
1111111111111111111
