111111111111111111111111111
100000ES00C000CCCCCCCC00101
1000SSSS000000C000000000001
1000000000C0000000001111111
1SSSSSSS000000C000001111111
1000C0CSC0C0000000000000001
11110000000CCCC000000000001
1000C00SSSSSSSSSSS000000001
1C0C00000000000000000000001
1SSSSSSSSSS00S0000000000C01
1000000000S00S0000111110C01
10P0000000000S0000111110C01
1000000000111100000CCCCCC01
111111111111111111111111111
