1111111111111
100000E100C01
1000111100001
1000000000C01
1111111100001
1000C0C1C0C01
11110000000C1
1P00C00111111
1C0C00C000001
1111111111111
