111111111111111
10000000E0C0001
100000000000001
1000000000C0001
100000000000001
1000C0C0C0C0001
100000000000001
1P00C0000000001
1C0C00000000001
111111111111111
