111111111111111111
100000E100C000CCC1
10001111000000C001
1000000000C0000001
11111111000000C001
1000C0C1C0C0000001
11110000000CCCC001
1P00C001111110C001
1C0C00000000000001
111111111111111111
