111111111111111111111111111
100000E100C000CCCCCCCC00101
10001111000000C000000000001
1000000000C0000000001111111
11111111000000C000001111111
1000C0C1C0C0000000000000001
11110000000CCCC000000000001
1000C0011111111111000000001
1C0C00000000000000000000001
111111111110010000000000C01
100000000010010000111110C01
10P000000000010000111110C01
1000000000111100000CCCCCC01
111111111111111111111111111
