111111111111111111111111111111111111111111111111111
10000000E0C0000000000000100000000000000000000000001
100000000000000000000000000000000000000000000000001
1000000000C0000000000000000000000000000000000000001
100000000000000000000000000000000000000000000000001
1000C0C0C0C0000000000000000000000000000000000000001
100000000000000000000000000000000000000000000000001
1P00C0000000000000000000000000000000000000000000001
1C0C00000000000000000000000000000000000000000000001
100000000000000000000000000000000000000000000000001
100000000000000000000000000000000000000000000000001
100000000000000000000000000000000000000000000000001
100000000000000000000000000000000000000000000000001
100000000000000000000000000000000000000000000000001
100000000000000000000000000000000000000000000000001
100000000000000000000000000000000000000000000000001
100000000000000000000000000000000000000000000000001
100000000000000000000000000000000000000000000000001
100000000000000000000000000000000000000000000000001
100000000000000000000000000000000000000000000000001
100000000000000000000000000000000000000000000000001
100000000000000000000000000000000000000000000000001
111111111111111111111111111111111111111111111111111
