1111111
1P00001
10C1CE1
101C1011
1111111
