1111111
1P00001
10C1CE1
11C1011
1111011
