1111111
1P00001
10W0CE1
100C001
1111111
