1111111111111111111
100C00CC00000000001
10PS000C000CCC00001
1SSS000S00000000001
100000CS00000000001
1000C0CS000CSSSSC01
1000CCC0000CS00CC01
1000000C000C000E001
1111111111111111111
