1111111111111111111
100C00CC00000000001
10P0100C000CCC00001
1111100100111110001
100000C100000000001
1000C1C1000C1000C01
1000C1C1000C100CC01
1000CCCC000C100E001
1111111111111111111
