1111111111111111111
100C00CC00000000001
10P0000C000CCC00001
1000000000000000001
100000C000000000001
1000C0C0000C0000C01
1000CCC0000C000CC01
1000000C000C000E001
1111111111111111111
