11111111111
100C00CC011
10P0100C011
11111001001
100000C1001
1000C1C1001
1000C1C1001
1000CCCCE01
11111111111
