1111111
1000001
1111111
10CCC01
1111111
