1111111
1P00001
10CCC01
1111111
