1111111
1P00001
10CCCE1
1111111
