1111111
1EC0001
10CC0P1
1111111
