111111111
1P0000001
1C0000001
1C00000E1
111111111
