1111111111
1EC0000111
10000001P1
1111111111
