1111111
1P00001
1111111
10CCCE1
1111111
