11111111
1EC11111
111111P1
11111111
