1111111111
1E11111111
1111C111P1
1111111111
