1111111
1P0EE01
1001CE1
101C101
1111111
