1111111
1P00001
10C1CE1
101C101
1111111
